111111111111
100000000001
10000C100001
110011E11111
100000100001
1000001000P1
100000000001
111111111111