111111111111
1E00000000C1
100000CC00P1
111111111111