111111111111
1E0000000001
100000C000P1
111111111111