111111111111
1E0000000001
10000C000P0   
111111111111