111111111111
1E00001000P1
10000C100001
111111111111