111111111111
1E00000000P1
100000C000P1
111111111111