111111111111
1C0000E0C001
1000001000P1
111111111111